1111111111111111111111111111111111
100000000000000C00000C000000000001
1010010100100000101001000000010101
101001001010101000100100000N010101
1P00000E0C00C000000000N000000000C1
1111111111111111111111111111111111
